000000000
000211110
000010010
000011110
000000000