111111111
101210101
101010101
100000001
121111121